111111111111111
101000000000001
101011110010001
100010000010001
110010011110001
110010000000001
100101111001111
100100001003001
100000100000001
111111111111111
